"filename", "language", "Java", "comment", "blank", "total"
"/Users/jamesweggel/Library/CloudStorage/OneDrive-DrexelUniversity/Classes/SE311/SE311-Homeworks/Assignment 4/Code/Client/src/jrw442/Calculator/Composite/AddSubExpression.java", "Java", 62, 2, 15, 79
"/Users/jamesweggel/Library/CloudStorage/OneDrive-DrexelUniversity/Classes/SE311/SE311-Homeworks/Assignment 4/Code/Client/src/jrw442/Calculator/Composite/AtomicExpression.java", "Java", 50, 1, 16, 67
"/Users/jamesweggel/Library/CloudStorage/OneDrive-DrexelUniversity/Classes/SE311/SE311-Homeworks/Assignment 4/Code/Client/src/jrw442/Calculator/Composite/Expression.java", "Java", 12, 0, 2, 14
"/Users/jamesweggel/Library/CloudStorage/OneDrive-DrexelUniversity/Classes/SE311/SE311-Homeworks/Assignment 4/Code/Client/src/jrw442/Calculator/Composite/MulDivExpression.java", "Java", 62, 2, 14, 78
"/Users/jamesweggel/Library/CloudStorage/OneDrive-DrexelUniversity/Classes/SE311/SE311-Homeworks/Assignment 4/Code/Client/src/jrw442/Calculator/Observer/CalculatorDriver.java", "Java", 122, 5, 29, 156
"/Users/jamesweggel/Library/CloudStorage/OneDrive-DrexelUniversity/Classes/SE311/SE311-Homeworks/Assignment 4/Code/Client/src/jrw442/Calculator/Observer/CalculatorView.java", "Java", 63, 4, 20, 87
"/Users/jamesweggel/Library/CloudStorage/OneDrive-DrexelUniversity/Classes/SE311/SE311-Homeworks/Assignment 4/Code/Client/src/jrw442/Calculator/State/Calculate.java", "Java", 29, 5, 21, 55
"/Users/jamesweggel/Library/CloudStorage/OneDrive-DrexelUniversity/Classes/SE311/SE311-Homeworks/Assignment 4/Code/Client/src/jrw442/Calculator/State/Error.java", "Java", 12, 0, 9, 21
"/Users/jamesweggel/Library/CloudStorage/OneDrive-DrexelUniversity/Classes/SE311/SE311-Homeworks/Assignment 4/Code/Client/src/jrw442/Calculator/State/GetAddSub.java", "Java", 59, 7, 9, 75
"/Users/jamesweggel/Library/CloudStorage/OneDrive-DrexelUniversity/Classes/SE311/SE311-Homeworks/Assignment 4/Code/Client/src/jrw442/Calculator/State/GetFirstOp.java", "Java", 28, 0, 5, 33
"/Users/jamesweggel/Library/CloudStorage/OneDrive-DrexelUniversity/Classes/SE311/SE311-Homeworks/Assignment 4/Code/Client/src/jrw442/Calculator/State/GetMulDiv.java", "Java", 69, 6, 10, 85
"/Users/jamesweggel/Library/CloudStorage/OneDrive-DrexelUniversity/Classes/SE311/SE311-Homeworks/Assignment 4/Code/Client/src/jrw442/Calculator/State/Start.java", "Java", 19, 1, 9, 29
"/Users/jamesweggel/Library/CloudStorage/OneDrive-DrexelUniversity/Classes/SE311/SE311-Homeworks/Assignment 4/Code/Client/src/jrw442/Calculator/State/State.java", "Java", 15, 0, 6, 21
"/Users/jamesweggel/Library/CloudStorage/OneDrive-DrexelUniversity/Classes/SE311/SE311-Homeworks/Assignment 4/Code/Client/src/jrw442/Calculator/State/StateContext.java", "Java", 8, 0, 8, 16
"/Users/jamesweggel/Library/CloudStorage/OneDrive-DrexelUniversity/Classes/SE311/SE311-Homeworks/Assignment 4/Code/Client/src/jrw442/Calculator/State/WaitAddSub.java", "Java", 21, 1, 9, 31
"/Users/jamesweggel/Library/CloudStorage/OneDrive-DrexelUniversity/Classes/SE311/SE311-Homeworks/Assignment 4/Code/Client/src/jrw442/Calculator/State/WaitMulDiv.java", "Java", 25, 1, 8, 34
"/Users/jamesweggel/Library/CloudStorage/OneDrive-DrexelUniversity/Classes/SE311/SE311-Homeworks/Assignment 4/Code/Client/src/jrw442/Calculator/Visitor/ExpressionVisitor.java", "Java", 9, 0, 6, 15
"/Users/jamesweggel/Library/CloudStorage/OneDrive-DrexelUniversity/Classes/SE311/SE311-Homeworks/Assignment 4/Code/Client/src/jrw442/Calculator/Visitor/ParserVisitor.java", "Java", 68, 3, 17, 88
"/Users/jamesweggel/Library/CloudStorage/OneDrive-DrexelUniversity/Classes/SE311/SE311-Homeworks/Assignment 4/Code/Client/src/jrw442/Calculator/Visitor/SolveVisitor.java", "Java", 48, 0, 13, 61
"/Users/jamesweggel/Library/CloudStorage/OneDrive-DrexelUniversity/Classes/SE311/SE311-Homeworks/Assignment 4/Code/Server/src/CalculatorServerDriver.java", "Java", 64, 7, 11, 82
"/Users/jamesweggel/Library/CloudStorage/OneDrive-DrexelUniversity/Classes/SE311/SE311-Homeworks/Assignment 4/Code/Server/src/Logger.java", "Java", 39, 3, 12, 54
"/Users/jamesweggel/Library/CloudStorage/OneDrive-DrexelUniversity/Classes/SE311/SE311-Homeworks/Assignment 4/Code/Server/src/RequestHandler.java", "Java", 34, 0, 9, 43
"Total", "-", 918, 48, 258, 1224